11111111111
1PCCCCCCCE1
1C11CCC11C1
1C1CCCCC1C1
1CCCC1CCCC1
1CCC111CCC1
1CCCC1CCCC1
1C1CCCCC1C1
1C11CCC11C1
1CCCCCCCCC1
11111111111