11111111111
1P0000000E1
101100011C1
10100000101
10000100001
10001110001
10000100001
10100C00101
10110001101
1C000000001
11111111111